4,4,4,4,4,4,4,4,4,4,4,4,4,4,4,4,4,4,4,4,4
4,4,1,0,0,0,0,0,0,0,0,0,0,0,0,0,0,0,0,0,4
4,4,0,0,0,0,0,0,0,0,0,0,0,0,0,0,0,0,0,0,4
4,4,0,0,0,0,0,0,0,0,0,0,0,0,0,0,0,0,0,0,4
4,4,4,4,4,5,5,5,5,5,5,5,5,5,5,5,5,0,0,0,4
4,4,4,5,5,5,5,5,5,5,5,5,5,5,5,5,5,0,0,0,4
4,4,4,5,5,5,5,5,5,5,5,5,5,5,5,5,5,0,0,0,4
4,4,4,5,5,5,5,5,5,5,5,5,5,5,5,5,5,0,0,0,4
4,4,0,0,0,0,0,0,0,0,0,0,0,0,0,0,0,0,0,0,4
4,4,0,0,0,0,0,0,0,0,0,0,0,0,0,0,0,0,0,0,4
4,4,0,0,0,0,0,0,0,0,0,0,0,0,0,0,0,0,0,0,4
4,4,0,0,0,2,2,2,2,2,2,2,2,2,2,2,2,2,2,2,4
4,4,0,0,0,2,2,2,2,2,2,2,2,2,2,2,2,2,2,2,4
4,4,6,0,0,2,2,2,2,2,2,2,2,2,2,2,2,2,2,2,4
4,4,4,4,4,4,4,4,4,4,4,4,4,4,4,4,4,4,4,4,4
