1,0,0,0,0,0,0,0,0,0,0,0,0,0,0,0
0,0,0,10,0,0,0,0,0,0,0,0,0,0,6,0
2,2,2,2,2,2,2,11,11,11,11,11,11,11,2,2
2,2,2,2,2,2,2,11,11,11,11,11,11,11,2,2
2,2,2,2,2,2,2,11,11,11,11,11,11,11,2,2
2,2,2,2,2,2,2,2,2,2,2,2,2,2,2,2
