0,0,0,0,0,0,0,0,0,0,0,0,0,0,0,0
0,0,0,0,0,0,0,0,0,0,0,0,0,0,0,0
0,0,0,0,0,0,0,0,0,0,0,0,0,0,0,0
0,0,0,0,0,0,0,0,0,0,0,0,0,0,0,0
20,0,18,0,0,0,0,0,0,0,0,0,0,0,21,0
2,2,2,2,19,19,19,19,19,19,19,19,19,19,19,19
