1,1,1,1,1,1,1,1,1,1,1,0,0,0,1,1,1,1,1,1,1
1,0,0,0,0,0,0,0,0,0,0,0,0,0,0,0,0,0,0,0,1
1,0,0,0,0,0,0,0,0,0,0,0,0,0,0,0,0,0,0,0,1
1,0,0,0,0,0,0,0,0,0,0,0,2,2,0,0,0,0,0,0,1
1,20,0,0,0,0,0,0,0,0,0,0,1,2,0,0,0,0,0,0,1
1,2,2,2,2,10,10,10,10,10,2,2,1,1,2,2,0,0,0,0,1
1,1,1,1,1,10,10,10,10,10,1,1,1,1,1,1,0,0,0,0,1
1,1,1,1,1,1,1,1,1,1,1,1,1,1,1,1,0,0,0,0,1
1,0,0,0,0,0,0,0,0,0,0,0,0,0,0,0,0,0,0,0,1
1,0,0,0,0,0,0,0,0,0,0,0,0,0,0,0,0,0,0,2,1
1,21,0,0,0,0,0,0,0,0,0,0,0,0,0,0,0,0,2,1,1
1,2,2,2,12,2,12,2,2,0,0,0,0,0,0,2,2,2,1,1,1
1,1,1,1,1,1,1,1,1,19,0,0,0,0,0,1,1,1,1,1,1
1,0,0,0,0,0,0,0,0,19,19,0,0,0,0,0,0,0,0,0,1
1,16,0,0,0,0,0,0,0,19,19,19,0,0,0,17,0,0,0,18,1
1,2,2,2,12,2,12,2,2,2,2,2,2,2,2,2,2,2,2,2,1
1,1,1,1,1,1,1,1,1,1,1,1,1,1,1,1,1,1,1,1,1
