1,0,0,0,0,0,0,0,0,0,0,0,0,7,0,0
0,0,0,0,0,0,0,0,0,0,0,0,0,0,0,0
0,0,0,0,0,0,0,0,0,0,0,0,0,0,0,0
0,0,0,0,0,10,0,0,0,0,0,0,0,0,0,6
2,2,2,2,2,2,2,11,11,11,11,11,11,11,11,11
2,2,2,2,2,2,2,2,2,2,2,2,2,2,2,2
